+--+--+--+--+--+
|              |
+  +--+--+  +  +
|  |     |  +  *
+--+  +  +  +  |
|           |  *
+**+-  --+*-+--+
|      |    g  *
+  +--+  +  +  +
|        |  +  |
+--+--+--+--+**+