+--+--+--+--+--+
|              |
+  +--+--+  +  +
|  |     |  +  *
+--+  +  +--+  +
|  g  |     |  *
+  +-++--+  +  +
|     |  |     *
+  +--+  +  +**+
|     |  |  +  |
+--+--+--+--+**+