+--+--+--+--+--+
|           *  |
+  +--+--+  +  +
|  |     |     *
+  +--+  +--+  +
|     |     |  *
+--+  +--+  +  +
|     |  |     *
+  +--+  +  +**+
|        |     g
+--+--+--+--+**+